feliz - happy
joven - young
mayor - older, oldest, greater, greatest
menor - younger, youngest, lesser, least
pasado,-a - past, last
poquito - a very little
primero,-a - first
querido,-a - dear
rápidamente - rapidly
viejo,-a - old
ciento - one hundred (when followed by another number)
doscientos,-as - two hundred
trescientos,-as - three hundred
cuatrocientos,-as - four hundred
quinientos,-as - five hundred
seiscientos,-as - six hundred
setecientos,-as - seven hundred
ochocientos,-as - eight hundred
novecientos,-as - nine hundred
mil - one thousand
abril - April
agosto - August
el año - year
el Año Nuevo - New Years Day
anteayer - the day before yesterday
ayer - yesterday
el cumpleaños - birthday
diciembre - December
enero - January
febrero - February
la fecha - date
julio - July
junio - June
marzo - March
mayo - May
el mes - month
la Navidad - Christmas
noviembre - November
octubre - October
pasado mañana - the day after tomorrow
septiembre - September
celebrar - to celebrate
cumplir (años) - to become
fue - to be (past tence)
venir - to come
a veces - at times, sometimes
de veras? - really
feliz cumpleaños! - happy birthday
la idea - idea
ni - not even
temprano - early
la vez (pl. veces) - time